Spauggreindin breyttist þannig að skopskynið varð svartara og jafnvel óskiljanlegt.	ruv
Thomas hefði ekki séð hana eftir að Nikolaj hvarf á braut í bílnum.	ruv
Skirrst er við að taka börn af heimili fyrr en í lengstu lög.	althingi
Svo hefði Tanya komið og þau farið.	domstolar
Hún miðaði að því að gera Nikolaj grunsamlegan og ábyrgan fyrir morðinu á Birnu.	ruv
Í ákæru er á því byggt að um tvö hnefahögg hafi verið að ræða.	domstolar
Slíkt próf kemur á markað á morgun.	visir
Loksins er komin lausn fyrir þurrkuntur og kynkaldar teprur þessa heims.	visir
Oftast eru þau hnéhá eða tæplega það.	wikipedia
Sigríður þurfti að segja upp Gunnari, Gjúki og Svandísi til að láta dæmið ganga upp.	from_rare
Hversu háa skál vil ég? Nú, ég vil alveg bolháa skál.	bin_extract
Hún hafði fundið fyrir þunglyndi og kynkulda, glímdi við ofþyngd og fleira.	ruv
EmJ benti á blessun stjórnarfarsins undanfarin ár.	althingi
Hér er allt í hönk!	from_rare
Mammon vor er alhreinn orðinn	althingi
Hann hafi verið með Kaj vini sínum og rætt við Annþór.	domstolar
Te veskú eins og skot.	morgunbladid
Tinna Rut og Leó Örn.	morgunbladid
Það er því mikilvægt, að olíuinnkaup séu sem hagkvæmust.	althingi
Þannig að þetta endurspeglar í rauninni sko aukin lífaldur þjóðarinnar.	stod2
Fyrir dóminum kvað Kaj framburð sinn fyrir lögreglu ósannan.	domstolar
Fékk eina góða, sko, eina stökka, sko.	stod2
Sigríður Eygló ólst upp í Vík í Mýrdal.	morgunbladid
Þetta gæti lifað sko kjarnorkustyrjöld þessi pakkning.	stod2
En það er ekki ykkar niðurstaða, þetta sé fyrst og fremst, sko, íslenskt hrun?	stod2
Og þar af leiðandi er sko óvissuástandið líka.	ras1_og_2
Þannig að hann er greinilega sko orðinn nokkuð útbreiddur þótt lítið sé af honum.	ras1_og_2
Ég veit ekkert um það en, en það er eiginlega sko, aukaatriði í þessu.	sjonvarpid
Sigurhjörtur átti sjö systkini, en tvö þeirra, Jósef Pálmar og Auður, létust í æsku.	morgunbladid
Sko, innstu blöðin, það eru bestu blöðin.	stod2
Hann hefur ekki skirrst við að fara í hana.	althingi
Nú standa allir í röð, fólk með pinkla og pjönkur.	morgunbladid
Þeir séu önugir og pirraðir.	ruv
Nú sé allt komið í hönk.	sjonvarpid
Í Hnífsdal fauk íbúðarhús á haf út.	ruv
Ég fæ hnút í magann yfir því að það á að styrkja byggð á Austurlandi.	althingi
Vasinn fannst þegar systkini gerðu upp dánarbú ættingja sinna í úthverfi Lundúna.	ruv
Afar þekkt þema í fornsögum og nægir að benda á hræðileg örlög Ödipusar sem dæmi.	morgunbladid
Konsertinum er lýst sem virtúósaverki sem leggi margar þrautir fyrir einleikarann.	morgunbladid
Fulltrúar dansa trúardans og fara með ritúöl.	from_rare
Ödipus var borinn út en bjargað af fjárhirðum og ættleiddur.	morgunbladid
Yngri pilturinn lést af sárum sínum, en hann hlaut alls sjö hnífsstungur.	visir
Þau hlupu í ofboði yfir lík.	ruv
Útsmoginn píanókennarinn sá við hrútnum.	from_rare
Framangreindur Kaj bar að hafa verið með Daníel og Kristófer í bílskúrnum heima hjá sér.	domstolar
Þeir Nikolaj hafi síðan ekið að Hafnarfjarðarhöfn, þar hafi Nikolaj farið um borð.	ruv
Þrjú kíló af nýjum fiski.	silfuregils
Margir tónlistarunnendur bíða spenntir eftir endurkomu þessarar hráu og pönkuðu rokksveitar.	visir
Þeir búa að sínum mikla olíuauði.	silfuregils
Eftir það veitti ákærði Hákoni tvö hnefahögg í andlitið.	domstolar
Sko, ætli aðalástæðan sé ekki sú, í fyrsta lagi er Júpíter rosalega stór.	stod2
Ég bjó í miðbæ Prag fyrir nokkrum árum.	morgunbladid
Ung íslensk kona varð þrettán milljónum ríkari í Lottó úrdrættinum um síðustu helgi.	visir
Sögnin „að stjónka“ í fyrstu persónu viðtengingarhætti, fleirtölu er „stjónkuðum“.	bin_extract
Í bæ hnútanna býr gömul kona sem þekkir til allra í næstu bæjum.	from_rare
Þorbjörn Tómasson, íbúi við Kársnesbraut í Kópavogi, spyr: „Oj bara, finnst þér ekki vond lykt hérna?“.	stod2
Þeir einu sem hafi tekið þátt í barsmíðum hafi verið Kaj og Smári.	domstolar
Það er kannske auðveldasta lausnin.	althingi
Marinó átti son fyrir hjónaband.	morgunbladid
Leki kom að hitaveituæð í Garðabæ nú síðdegis.	ruv
Tríó Árna Ísleifs leikur undir.	wikipedia
Bættu góðri fitu í matinn; örlítil lárpera, fræ, hnetur eða góð ólífuolía.	visir
Beötu hafði aldrei fundist Bersabesynir sérstaklega skemmtilegir.	from_rare
Saman unnu þeir til sjö Óskarsverðlauna.	morgunbladid
Hefur þú komið til Túvalúeyjar?	from_rare
Kristján endurtekur: „Sem miðstöð altso innanlandsflugs“.	sjonvarpid
Þannig að hann slær út bæði sko, Árna Sigfússon og Lúðvík Geirsson.	sjonvarpid
Og þó hló enginn maður.	althingi
Sem og að sko, eiga samtal við hið alþjóðlega umhverfi.	sjonvarpid
Já, ég var sko öfunduð af þessari góðu ömmu á þessum árum.	morgunbladid
